MODE 2
SIZE 9/8
LIMIT 1/60
COLOR LIMIT 5
STARS 3200/8600/15000
COLLECT ITEMS 0/2/
COLLECT COUNT 20/20/
10 10 10 10 10 10 10 10 10
10 10 10 10 10 10 10 10 10
10 10 10 00 10 00 10 10 10
10 10 00 00 00 00 00 10 10
10 10 00 00 00 00 00 10 10
10 10 10 00 00 00 10 10 10
10 10 10 10 00 10 10 10 10
18 10 10 10 10 10 10 10 18