MODE 3
SIZE 9/8
LIMIT 0/20
COLOR LIMIT 5
STARS 3200/8600/15000
COLLECT ITEMS 
00 10 10 10 10 10 20 14 20
10 10 10 10 10 20 14 20 10
10 10 10 10 60 14 20 10 10
10 10 10 60 14 60 10 10 10
10 10 60 14 60 10 10 10 10
10 20 14 60 10 10 10 10 10
20 14 20 10 10 10 10 10 10
14 20 10 10 10 10 10 10 00