MODE 3
SIZE 8/8
LIMIT 0/20
COLOR LIMIT 5
STARS 3200/8600/15000
COLLECT ITEMS 
10 10 10 10 10 10 10 10
10 10 10 10 10 10 10 10
10 14 00 60 60 00 14 10
10 10 20 00 00 20 10 10
10 10 20 00 00 20 10 10
10 10 00 20 20 00 10 10
10 10 10 10 10 10 10 10
10 10 10 10 10 10 10 10