MODE 0
SIZE 8/8
LIMIT 1/60
COLOR LIMIT 5
STARS 3200/8600/15000
GETSTARS 2
00 10 10 10 10 10 10 00
10 10 10 10 10 10 10 10
10 14 10 00 00 10 14 10
10 10 10 00 00 10 10 10
10 10 10 10 10 10 10 10
10 14 14 14 14 14 14 10
10 00 00 18 18 00 00 10
10 10 10 10 10 10 10 10