MODE 4
SIZE 8/5
LIMIT 0/15
COLOR LIMIT 3
STARS 3200/8600/15000
CAGE 20
10 10 10 10 10 10 10 10
10 10 10 10 10 10 10 10
10 10 10 10 10 10 10 10
18 13 13 13 13 13 10 10
13 13 13 13 13 18 10 10