MODE 3
SIZE 9/8
LIMIT 0/20
COLOR LIMIT 5
STARS 3200/8600/15000
COLLECT ITEMS 
00 18 10 10 60 10 10 18 00
10 10 10 10 60 10 10 10 10
10 10 10 10 60 10 10 10 10
20 10 20 10 60 10 20 10 20
10 20 10 20 60 20 10 20 10
10 10 10 10 60 10 10 10 10
10 10 10 10 60 10 10 10 10
00 18 10 10 60 10 10 18 00