MODE 0
SIZE 8/8
LIMIT 1/60
COLOR LIMIT 5
STARS 3200/8600/15000
GETSTARS 2
10 10 10 15 15 10 10 10
10 10 10 10 10 10 10 10
10 10 00 10 10 00 10 10
15 10 10 00 00 10 10 15
15 10 10 00 00 10 10 15
10 10 00 10 10 00 10 10
10 10 10 10 10 10 10 10
10 10 10 15 15 10 10 10