MODE 1
SIZE 8/8
LIMIT 0/20
COLOR LIMIT 5
STARS 3200/8600/15000
COLLECT ITEMS 0/1/
COLLECT COUNT 2/2/
10 10 10 10 10 10 10 10
10 10 10 10 10 10 10 10
10 10 10 14 14 10 10 10
00 00 10 14 14 10 00 00
00 00 10 10 10 10 00 00
10 10 10 10 10 10 10 10
10 10 10 00 00 10 10 10
10 10 10 00 00 10 10 10