MODE 3
SIZE 8/7
LIMIT 0/20
COLOR LIMIT 5
STARS 3200/8600/15000
COLLECT ITEMS 
00 10 10 10 10 14 60 14
10 10 10 10 14 60 14 10
10 10 10 14 60 14 10 10
00 10 14 60 00 14 10 00
10 10 10 14 60 14 10 10
10 10 14 60 14 10 10 10
00 10 60 10 10 10 10 00