MODE 2
SIZE 8/8
LIMIT 0/20
COLOR LIMIT 5
STARS 3200/8600/15000
COLLECT ITEMS 3/4/
COLLECT COUNT 20/20/
10 10 10 00 00 10 10 10
10 10 10 00 00 10 10 10
10 10 10 10 10 10 10 10
10 00 10 00 00 10 00 10
10 00 10 00 00 10 00 10
10 10 10 10 10 10 10 10
10 10 10 00 00 10 10 10
10 10 10 00 00 10 10 10