MODE 4
SIZE 8/8
LIMIT 0/20
COLOR LIMIT 5
STARS 3200/8600/15000
CAGE 10
00 10 10 00 00 10 10 00
10 10 10 10 10 10 10 10
10 10 10 10 10 10 10 10
10 13 10 13 13 10 13 10
10 10 10 10 10 10 10 10
10 10 00 13 10 00 10 10
10 00 10 10 13 10 00 10
00 10 10 10 10 10 10 00