MODE 3
SIZE 8/8
LIMIT 0/20
COLOR LIMIT 5
STARS 3200/8600/15000
COLLECT ITEMS 
00 10 10 10 10 10 10 00
10 00 10 10 10 10 00 10
10 10 60 20 20 60 10 10
10 10 20 00 00 20 10 10
10 10 20 00 00 20 10 10
10 10 60 20 20 60 10 10
10 00 10 10 10 10 00 10
00 10 10 10 10 10 10 00