MODE 3
SIZE 8/8
LIMIT 0/20
COLOR LIMIT 5
STARS 3200/8600/15000
COLLECT ITEMS 
10 10 10 10 10 10 10 10
10 10 10 14 14 10 10 10
10 10 14 60 60 14 10 10
10 14 14 60 60 14 14 10
10 14 60 15 15 60 14 10
10 10 14 60 60 14 10 10
10 10 10 14 14 10 10 10
10 10 10 10 10 10 10 10