MODE 3
SIZE 8/6
LIMIT 0/20
COLOR LIMIT 5
STARS 3200/8600/15000
COLLECT ITEMS 
10 10 10 10 10 10 10 10
10 14 14 14 14 14 14 10
10 10 60 20 20 60 10 10
10 14 14 14 14 14 14 10
10 10 60 20 20 60 10 10
10 10 10 10 10 10 10 10