MODE 3
SIZE 8/6
LIMIT 0/20
COLOR LIMIT 5
STARS 3200/8600/15000
COLLECT ITEMS 
10 10 10 14 14 10 10 10
10 10 10 60 60 10 10 10
10 10 14 20 20 14 10 10
10 14 60 00 00 60 14 10
10 10 10 20 20 10 10 10
10 10 10 10 10 10 10 10