MODE 1
SIZE 8/6
LIMIT 0/20
COLOR LIMIT 5
STARS 3200/8600/15000
COLLECT ITEMS 0/1/
COLLECT COUNT 2/2/
10 10 10 00 00 10 10 10
10 10 10 10 10 10 10 10
00 14 14 14 14 14 14 00
10 10 10 10 10 10 10 10
10 10 10 10 10 10 10 10
10 10 10 00 00 10 10 10