MODE 2
SIZE 8/10
LIMIT 0/10
COLOR LIMIT 6
STARS 3200/8600/15000
COLLECT ITEMS 0/1/
COLLECT COUNT 10/15/
10 10 10 10 10 10 10 10
18 10 10 10 10 10 10 10
10 10 10 10 10 10 10 10
00 10 10 10 10 18 10 10
10 10 10 10 10 00 10 10
00 10 10 10 10 10 10 10
10 10 18 10 10 00 10 10
10 10 10 10 10 10 10 10
18 18 10 10 10 10 10 10
10 10 10 10 10 10 10 10