MODE 1
SIZE 8/8
LIMIT 0/20
COLOR LIMIT 5
STARS 3200/8600/15000
COLLECT ITEMS 0/1/
COLLECT COUNT 3/3/
10 10 10 10 10 10 10 10
10 10 10 10 10 10 10 10
10 10 10 15 15 10 10 10
10 10 14 10 10 14 10 10
18 10 10 10 10 10 10 18
00 10 10 10 10 10 10 00
00 00 10 10 10 10 00 00
00 00 00 10 10 00 00 00