MODE 3
SIZE 8/7
LIMIT 0/20
COLOR LIMIT 5
STARS 3200/8600/15000
COLLECT ITEMS 
10 10 10 14 10 10 10 10
10 10 14 20 14 10 10 10
10 14 20 00 20 14 10 10
14 20 10 20 00 20 14 10
20 10 20 10 20 14 10 10
10 20 10 20 14 10 10 10
10 10 20 14 10 10 10 10