MODE 5
SIZE 8/8
LIMIT 0/20
COLOR LIMIT 5
STARS 3200/8600/15000
GETSTARS 2
BOMBS 5/10
10 10 10 00 00 10 10 10
10 14 10 10 10 10 14 10
10 10 10 10 10 10 10 10
10 00 00 15 15 00 00 10
10 00 00 15 15 00 00 10
10 10 10 10 10 10 10 10
10 14 10 10 10 10 14 10
10 10 10 00 00 10 10 10