MODE 3
SIZE 8/8
LIMIT 0/25
COLOR LIMIT 5
STARS 3200/8600/15000
COLLECT ITEMS 
00 10 10 10 10 10 10 00
10 10 10 10 10 10 10 10
10 10 15 15 15 15 10 10
10 10 15 60 60 15 10 10
10 10 15 60 60 15 10 10
10 10 15 15 15 15 10 10
10 10 10 10 10 10 10 10
00 10 10 10 10 10 10 00